Problems x Languages,C,C++,C++11,Java,Python2,Python3,Total
A,4,63,26,6,2,1,102
B,0,41,42,5,0,0,88
C,0,1,4,0,0,0,5
D,0,45,42,6,1,0,94
F,0,66,32,7,1,1,107
G,0,39,19,6,0,1,65
H,1,72,54,9,3,0,139
I,0,18,9,0,0,0,27
J,0,59,56,3,1,3,122
K,0,69,68,3,0,0,140
