Problems x Languages,C,C++,C++11,Java,Total
A,0,84,19,7,110
B,0,40,13,0,53
C,0,14,10,0,24
D,11,82,18,10,121
E,0,53,14,0,67
F,0,15,14,0,29
G,0,16,41,0,57
H,1,86,31,1,119
I,4,47,13,4,68
J,0,3,4,1,8
K,0,32,11,0,43
