Problems x Languages,C,C++11,Java,Python2,Python3,Total
A,0,3,0,0,0,3
B,0,38,3,0,0,41
C,7,147,8,0,4,166
D,0,22,3,0,0,25
E,0,50,5,6,9,70
F,0,89,9,0,0,98
G,0,29,0,0,0,29
H,0,64,9,0,3,76
I,0,99,1,0,0,100
J,0,67,4,0,0,71
K,0,0,0,0,0,0
L,0,2,0,0,0,2
M,0,35,0,0,0,35
