Problems x Answers,NO - Class name mismatch,NO - Compilation error,NO - Output format error,NO - Runtime error,NO - Time limit exceeded,NO - Wrong Language Choice,NO - Wrong answer,YES,Total
A,0,0,0,0,2,0,0,1,3
B,0,1,0,0,5,0,19,16,41
C,0,1,1,8,3,0,93,60,166
D,0,0,0,3,4,1,12,5,25
E,1,0,2,0,7,1,34,25,70
F,0,1,0,5,7,0,61,24,98
G,0,0,0,0,0,0,15,14,29
H,0,0,0,3,0,0,1,72,76
I,0,3,0,8,26,0,33,30,100
J,0,0,0,0,16,0,32,23,71
K,0,0,0,0,0,0,0,0,0
L,0,0,0,0,0,0,1,1,2
M,0,0,0,2,7,0,15,11,35
