Problems x Answers,No - Compilation error,No - Incorrect output,No - Output format error,No - Runtime error,No - Time limit exceeded,YES,Total
A,0,10,0,1,0,1,12
B,0,0,0,0,0,0,0
C,1,60,0,1,5,30,97
D,0,31,0,3,5,2,41
E,0,17,0,0,9,2,28
F,2,14,0,4,29,8,57
G,2,42,5,8,4,29,90
H,0,26,0,0,0,48,74
I,0,53,0,2,4,12,71
J,0,4,0,0,0,0,4
