Problems x Answers,NO - Compilation error,NO - Presentation error,NO - Runtime error,NO - Time limit exceeded,NO - Wrong answer,YES,Total
A,1,0,1,0,5,58,65
B,1,0,0,0,48,22,71
C,1,0,11,44,38,29,123
D,1,0,0,0,5,1,7
E,0,0,0,7,6,8,21
F,0,0,0,0,4,2,6
G,0,0,1,14,19,20,54
H,0,0,4,5,69,40,118
I,0,1,5,1,18,26,51
J,0,0,0,0,0,2,2
K,0,0,0,4,4,1,9
