Problems x Answers,NO - Compilation error,NO - Filename Mismatch,NO - Presentation error,NO - Runtime error,NO - Time limit exceeded,NO - Wrong answer,YES,Total
A,0,1,0,1,4,56,48,110
B,2,0,0,1,5,34,11,53
C,0,0,0,2,2,12,8,24
D,2,0,0,3,0,50,66,121
E,0,0,0,3,2,34,28,67
F,1,0,0,1,3,18,6,29
G,1,0,0,0,2,40,14,57
H,1,0,0,0,0,98,20,119
I,0,0,0,0,0,0,68,68
J,0,1,2,0,0,1,4,8
K,2,0,0,1,27,8,5,43
