Problems x Answers,NO - Compilation error,NO - Presentation error,NO - Runtime error,NO - Time limit exceeded,NO - Wrong answer,NO - Wrong language choice,YES,Total
A,2,0,0,0,27,0,73,102
B,1,0,7,20,30,0,30,88
C,0,0,0,0,1,0,4,5
D,0,1,1,3,31,0,58,94
F,1,1,4,0,29,0,72,107
G,1,0,1,17,38,1,7,65
H,3,0,9,34,72,0,21,139
I,0,1,1,14,6,0,5,27
J,1,0,2,6,72,0,41,122
K,0,0,0,2,105,1,32,140
