Problems x Answers,NO - Compilation error,NO - Runtime error,NO - Time limit exceeded,NO - Wrong answer,YES,Total
A,1,0,14,27,2,44
B,0,0,0,0,0,0
C,1,13,1,10,31,56
D,0,0,0,8,49,57
E,0,0,29,39,7,75
F,1,1,1,0,4,7
G,1,1,13,21,5,41
H,0,1,0,6,49,56
I,4,11,87,22,29,153
J,0,6,28,14,7,55
