Problems x Answers,NO - Compilation error,NO - File name mismatch,NO - Runtime error,NO - Time limit exceeded,NO - Wrong answer,YES,Total
A,1,0,9,4,38,16,68
B,1,0,1,11,10,0,23
C,0,1,0,1,3,36,41
D,0,0,0,2,8,9,19
E,1,0,0,4,15,7,27
F,0,0,2,20,82,54,158
G,1,0,3,13,67,15,99
H,0,0,0,1,4,0,5
I,0,0,0,0,8,0,8
J,1,0,1,0,16,10,28
